我想咨询	闲聊-问候
不、客气	闲聊-其他
操你妈逼的	闲聊-骂人
好的谢谢	闲聊-感谢
晕	闲聊-其他
晕	闲聊-其他
操你妈的	闲聊-骂人
聊聊	闲聊-问候
客服您好	闲聊-问候
你好丫	闲聊-问候
在吗在吗在吗	闲聊-问候
你好吧你好	闲聊-问候
这个问题怎么解决	闲聊-其他
不解决天天骂混帐，	闲聊-骂人
到底什么意思啊	闲聊-其他
怎么办。	闲聊-其他
能不能帮我解决一下呢	闲聊-问候
他妈的	闲聊-骂人
傻屌一样的388元一年？？？？	闲聊-骂人
你大爷的	闲聊-骂人
你可以帮我完成吗	闲聊-其他
操你们老板	闲聊-骂人
在！？？？？？	闲聊-问候
在吗？？	闲聊-问候
不会脸	闲聊-其他
你好人工吗？	闲聊-问候
你帮我	闲聊-其他
咨询一件事	闲聊-问候
你好，请给答复	闲聊-问候
我去你大爷	闲聊-骂人
说ⅰ话	闲聊-问候
亲，在吗？	闲聊-问候
好的谢谢	闲聊-感谢
我你好	闲聊-问候
有没有人？	闲聊-问候
你好，在不在？	闲聊-问候
我要怎么办	闲聊-其他
对您的服务非常满意。	闲聊-感谢
你好，客服在吗	闲聊-问候
他妈的，有人吗	闲聊-骂人
操你妈逼	闲聊-骂人
在么在么	闲聊-问候
机器你妈逼	闲聊-骂人
操你妈	闲聊-骂人
机器人啊？	闲聊-机器人
有没有听到	闲聊-其他
怎么都是机器人啊	闲聊-机器人
有人在吗？3	闲聊-问候
你大爷	闲聊-骂人
我给你好	闲聊-问候
啥东西嘛	闲聊-骂人
在im	闲聊-问候
吃饭呢	闲聊-其他
请帮我	闲聊-问候
sb	闲聊-骂人
您好！在吗？	闲聊-问候
你好在线吗	闲聊-问候
你好，你在吗？	闲聊-问候
人工吗？	闲聊-机器人
在吗】	闲聊-问候
午好！	闲聊-问候
你好..在吗	闲聊-问候
z在？	闲聊-问候
