`情人节哪天	闲聊-其他
fuck	闲聊-骂人
j你好	闲聊-问候
nih你好	闲聊-问候
n你好	闲聊-问候
Okay	闲聊-其他
OK谢谢	闲聊-感谢
白痴	闲聊-骂人
帮处理	闲聊-问候
不用了	闲聊-其他
操	闲聊-骂人
操你	闲聊-骂人
操你妈的逼	闲聊-骂人
操你妈个逼	闲聊-骂人
曹尼玛	闲聊-骂人
曹尼玛的	闲聊-骂人
草尼玛	闲聊-骂人
扯淡	闲聊-骂人
答非所问！	闲聊-其他
叼	闲聊-骂人
都没人回应呀	闲聊-问候
非常满意	闲聊-其他
乀(ˉεˉ乀)滚你妈的	闲聊-骂人
干你老娘	闲聊-骂人
工号22好	闲聊-问候
滚	闲聊-骂人
哈喽	闲聊-问候
嗨	闲聊-问候
嗨，你好	闲聊-问候
好	闲聊-其他
好，谢谢	闲聊-感谢
好吧	闲聊-其他
好的	闲聊-其他
好的，谢谢	闲聊-感谢
好的！谢谢你	闲聊-感谢
好了	闲聊-其他
好了，谢谢	闲聊-感谢
机器人	闲聊-机器人
机器人？	闲聊-机器人
机器人就滚蛋	闲聊-骂人
简直太垃圾了	闲聊-骂人
叫你去吃屎	闲聊-骂人
就是骗人的	闲聊-骂人
看见回复我解决	闲聊-问候
靠	闲聊-骂人
靠你老母	闲聊-骂人
可以吗	闲聊-其他
可以吗！	闲聊-其他
客服好	闲聊-问候
客服你好	闲聊-问候
客服您好！	闲聊-问候
客服在吗	闲聊-问候
客服在吗？	闲聊-问候
客服在吗？看到我的留言麻烦请回复我	闲聊-问候
客服在嘛	闲聊-问候
客服在没	闲聊-问候
垃圾	闲聊-骂人
垃圾，网^_^	闲聊-骂人
妈的	闲聊-骂人
没人啊	闲聊-问候
没人的嘛	闲聊-问候
没人回复我	闲聊-问候
没有解决	闲聊-其他
没有人理我	闲聊-问候
嗯	闲聊-其他
嗯嗯	闲聊-其他
恁好	闲聊-问候
能帮助我一下吗？谢谢了。	闲聊-问候
能回答我的问题不	闲聊-问候
能回复我我	闲聊-问候
能找到对象吗	闲聊-其他
尼玛	闲聊-骂人
尼玛人都死了嘛，用机器人	闲聊-骂人
你废话	闲聊-骂人
你还在吗	闲聊-问候
你好	闲聊-问候
你好'	闲聊-问候
你好，	闲聊-问候
你好，你在么？	闲聊-问候
你好，请问在吗	闲聊-问候
你好，问题要问。	闲聊-问候
你好，我想请问一下	闲聊-问候
你好，有人吗	闲聊-问候
你好，有人吗？	闲聊-问候
你好，在不	闲聊-问候
你好，在吗	闲聊-问候
你好，在吗？	闲聊-问候
你好，怎么办	闲聊-问候
你好！	闲聊-问候
你好！！	闲聊-问候
你好！我是杜鹏飞	闲聊-问候
你好！在吗？	闲聊-问候
你好？	闲聊-问候
你好.	闲聊-问候
你好^_^	闲聊-问候
你好b	闲聊-问候
你好o	闲聊-问候
你好s	闲聊-问候
你好w	闲聊-问候
你好、	闲聊-问候
你好。	闲聊-问候
你好啊	闲聊-问候
你好客服在吗	闲聊-问候
你好能与你相识缘份	闲聊-其他
你好你好	闲聊-问候
你好你好你	闲聊-问候
你好亲	闲聊-问候
你好请教一下	闲聊-问候
你好是客服嘛	闲聊-问候
你好我	闲聊-问候
你好我想	闲聊-问候
你好小爱。	闲聊-问候
你好有人吗？	闲聊-问候
你好在不？	闲聊-问候
你好在吗	闲聊-问候
你好在吗？	闲聊-问候
你好在么	闲聊-问候
你可以帮我吗？	闲聊-问候
你可以去死	闲聊-骂人
你老母	闲聊-骂人
你妈	闲聊-骂人
你妈逼	闲聊-骂人
你妈的批	闲聊-骂人
你妈的签批	闲聊-骂人
你妈个逼	闲聊-骂人
你妈卖批	闲聊-骂人
你妈批	闲聊-骂人
你麻痹	闲聊-骂人
你妹	闲聊-骂人
你妹的	闲聊-骂人
你们就是垃圾	闲聊-骂人
你能帮我吗	闲聊-问候
你你好	闲聊-问候
你去死，垃圾	闲聊-骂人
你去死吧	闲聊-骂人
你若安好	闲聊-其他
你是？	闲聊-问候
你是不是智障	闲聊-骂人
你是机器人?	闲聊-机器人
你是谁	闲聊-问候
你是真人还是假的	闲聊-机器人
你收到吗请回复	闲聊-问候
你要死啊	闲聊-骂人
你在	闲聊-问候
你在吗	闲聊-问候
您好	闲聊-问候
您好，在吗	闲聊-问候
您好，早安	闲聊-问候
您好！	闲聊-问候
您好0	闲聊-问候
您好。	闲聊-问候
您好客服	闲聊-问候
您好在吗	闲聊-问候
亲	闲聊-问候
亲，打扰啦	闲聊-问候
亲，你好	闲聊-问候
亲，你好，在吗？	闲聊-问候
亲，您好	闲聊-问候
亲，在吗	闲聊-问候
亲，在么？	闲聊-问候
亲！你好	闲聊-问候
亲爱的	闲聊-问候
亲你好	闲聊-问候
亲亲在吗	闲聊-问候
亲在吗	闲聊-问候
请帮忙解决	闲聊-问候
请回答	闲聊-问候
请回答并协助解决我的问题，谢谢	闲聊-问候
请你帮我处理一下。	闲聊-问候
请问	闲聊-问候
请问下	闲聊-问候
请问一下	闲聊-问候
请问有人吗	闲聊-问候
请问在吗	闲聊-问候
去你妈逼	闲聊-骂人
去你妈的，你不能直接说需登录电脑呀	闲聊-骂人
去死吧	闲聊-骂人
去他马的	闲聊-骂人
人工智能	闲聊-机器人
人工智能？	闲聊-机器人
人呢	闲聊-问候
如何表白	闲聊-其他
如何和心仪男生聊天	闲聊-其他
傻逼	闲聊-骂人
什么鸡巴	闲聊-骂人
什么垃圾	闲聊-骂人
什么破玩意	闲聊-骂人
什么玩应啊	闲聊-骂人
神经病	闲聊-骂人
是你大爷	闲聊-骂人
是真人	闲聊-机器人
收到请及时回复	闲聊-问候
死了吗	闲聊-骂人
死人？	闲聊-骂人
太恶心了	闲聊-骂人
太垃圾了	闲聊-骂人
晚上好	闲聊-问候
晚上好！	闲聊-问候
我爱你	闲聊-其他
我操你妈	闲聊-骂人
我好难过	闲聊-其他
我日你妈	闲聊-骂人
我试试，不懂再问你。	闲聊-其他
我试试，谢谢！	闲聊-感谢
我是你爹	闲聊-骂人
我是你爷爷	闲聊-骂人
我问你问题呢	闲聊-问候
我想问一个问题	闲聊-问候
我想问一下	闲聊-问候
我想咨询一下	闲聊-问候
我需要帮助	闲聊-问候
我有问题要问	闲聊-问候
想问	闲聊-问候
想问下	闲聊-问候
想问一下	闲聊-问候
小爱你好	闲聊-问候
谢谢	闲聊-感谢
谢谢，打扰您了	闲聊-感谢
谢谢了	闲聊-感谢
谢谢你	闲聊-感谢
有病啊	闲聊-骂人
有客服在吗？	闲聊-问候
有毛用	闲聊-骂人
有没有人	闲聊-问候
有没有人在	闲聊-问候
有没有在在？	闲聊-问候
有人	闲聊-问候
有人？	闲聊-问候
有人吗	闲聊-问候
有人吗？	闲聊-问候
有人么	闲聊-问候
有人没	闲聊-问候
有人没？	闲聊-问候
有人在	闲聊-问候
有人在？	闲聊-问候
有人在吗	闲聊-问候
有人在吗？	闲聊-问候
有人在么？	闲聊-问候
有人在哪	闲聊-问候
有事打搅	闲聊-问候
有在吗	闲聊-问候
有真人吗	闲聊-机器人
有真人吗？	闲聊-机器人
杂种	闲聊-骂人
在	闲聊-问候
在？	闲聊-问候
在m?q	闲聊-问候
在啊	闲聊-问候
在不	闲聊-问候
在不，亲	闲聊-问候
在不？	闲聊-问候
在不在	闲聊-问候
在不在？	闲聊-问候
在不在啊	闲聊-问候
在的？	闲聊-问候
在马	闲聊-问候
在吗	闲聊-问候
在吗？	闲聊-问候
在吗？您好	闲聊-问候
在吗》	闲聊-问候
在吗客服	闲聊-问候
在吗你好	闲聊-问候
在吗您好	闲聊-问候
在吗亲	闲聊-问候
在吗在吗	闲聊-问候
在嘛	闲聊-问候
在么	闲聊-问候
在么？	闲聊-问候
在么你好	闲聊-问候
在没	闲聊-问候
早	闲聊-问候
早上好	闲聊-问候
怎么没回音啊	闲聊-问候
怎么没人？	闲聊-问候
真想骂人	闲聊-骂人
